12 90 13
000000000000000000000000000000000000000000000000000000000000000000000000000000000000000000
000000000000000000000000000000000000000000000000000000000000000000000000000000000000000000
000000000000000000000000000000000000000000000000000000000000000000000000000000000000000000
0000000000000000000000000000000000000000000000000000000000+00000000000TTT00000000++0000000
000000000000000000000000000000000000000000000000000000000TQTT00000000000000TTT00++++000000
000000000000000000000000000TTT00++++0000000000000000000000000000TTTTT00000T000T0TTTT000000
00000000000000000++0000000000000TQQTT0000000TTTT00000000000000TTT0000000000000000000000000
00000000000000000TT0000TTTT0000000000000000000000000000000+00TQ000000000000000000000000000
T000000000000000000QQ000000000000000000TTTTT00000000000000T000000000000000000T0T0000000000
T0000000000TQT000000000000000000000000000000+++0000000000+T+00000000000000T00T000000000000
T000000000000000T00000000000000+++++00000000+++000000000+TTT+0000000000000T00T000000000000
T000000000000000000000000000000TTTTT00000000+++00000000+TTTTT+000000000000T00T000000H00000
AAAAAAAAAAAAAAAAAAAAAAAAAAAAAAAAAAAAAAAAAAAAAAAAAAAAAAAAAAAAAAAAAAAAAAAAAAAAAAAAAAAAAAAAAA
8 3 M
4 47 M
7 13 M
3 68 M
1 72 M
9 12 L
9 18 L
7 32 L
9 35 L
8 59 L
4 46 H
7 12 H
5 23 H