000000000000000000000000000000000000000000000000000000000000000000000000000000000000000000
000000000000000000000000000000000000000000000000000000000000000000000000000000000000000000
000000000000000000000000000000000000000000000000000000000000000000000000000000000000000000
000000000000000000000000000000000000000000000000000000000000000000000000000000000000000000
000000000000000000000000000000000000000000000000000000000000000000000000000000000TTTT00000
00000000000000000000000000000000TTTT000000000000000000000000000000000000000000000000000000
00000000000000000TTTT0000T00000000000000000000000000000000T000000000000000000T000000000000
T000000000000000000TT0000000000000000000000000000000000000T000000000000000000T000000000000
T0000000000TTT00000000000000000000000000000000000000000000T00000000000000T000T000000000000
T00000000000000000000000000000000000000000000000000000000TTT0000000000000T000T000000000000
T000000000000000000000000000000TTTTT00000000000000000000TTTTT000000000000T000T000000000000
AAAAAAAAAAAAAAAAAAAAAAAAAAAAAAAAAAAAAAAAAAAAAAAAAAAAAAAAAAAAAAAAAAAAAAAAAAAAAAAAAAAAAAAAAA