12 90 7
000000000000000000000000000000000000000000000000000000000000000000000000000000000000000000
000000000000000000000000000000000000000000000000000000000000000000000000000000000000000000
00000000000000000000000000000000000TQTT0000TQTTQ000000000000000000000000000000000000000000
0000000000000000000000000000000000000000000000000000000000+00000000000TTT00000000++0000000
000000000000000000000000000000000000000000000000000000000TQT000000000000000TTT00++++000000
00000000000000000000000000000000++++0000000000000000000000000000TTTT000000000000TTTT000000
00000000000000000++0000000000000TQQT00000000TTTT00000000000000TTT0000000000000000000000000
00000000000000000TT0000TTTT00T0000000000000000000000000000+000000000000000000T000000000000
T000000000000000000QQ000000000000000000TTT0000000000000000T000000000000000000T000000000000
T0000000000TQT000000000000000000000000000000+++0000000000+T+00000000000000T00T000000000000
T000000000000000T00000000000000+++++00000000+++000000000+TTT+0000000000000T00T000000000000
T000000000000000000000000000000TTTTT00000000+++00000000+TTTTT+000000000000T00T000000H00000
AAAAAAAAAAAAAAAAAAAAAAAAAAAAAAAAAAAAAAAAAAAAAAAAAAAAAAAAAAAAAAAAAAAAAAAAAAAAAAAAAAAAAAAAAA
9 3 R
9 6 R
9 12 L
9 18 L
7 32 L
9 35 L
8 59 L
