12 90 4
000000000000000000000000000000000000000000000000000000000000000000000000000000000000000000
000000000000000000000000000000000000000000000000000000000000000000000000000000000000000000
000000000000000000000000000000000000000000000000000000000000000000000000000000000000000000
0000000000000000000000000000000000000000000000000000000000+0000000000000000000000++0000000
000000000000000000000000000000000000000000000000000000000TQT00000000000000000000++++000000
00000000000000000000000000000000++++00000000000000000000000000000000000000000000TTTT000000
00000000000000000++0000000000000TQQT000000000000000000000000000000000000000000000000000000
00000000000000000TT0000TTTT00T0000000000000000000000000000+000000000000000000T000000000000
T000000000000000000QQ0000000000000000000000000000000000000T000000000000000000T000000000000
T0000000000TQT000000000000000000000000000000+++0000000000+T+00000000000000T00T000000000000
T000000000000000T00000000000000+++++00000000+++000000000+TTT+0000000000000T00T000000000000
T000000000000000000000000000000TTTTT00000000+++00000000+TTTTT+000000000000T00T00000000H000
AAAAAAAAAAAAAAAAAAAAAAAAAAAAAAAAAAAAAAAAAAAAAAAAAAAAAAAAAAAAAAAAAAAAAAAAAAAAAAAAAAAAAAAAAA
10 3 M
10 6 M
9 12 L
9 18 L