12 90 14
000000000000000000000000000000000000000000000000000000000000000000000000000000000000000000
000000000000000000000000000000000000000000000000000000000000000000000000000000000000000000
00000000QQ000000000000000000Q00000000000000000Q0000000000000000000000000000000000000000000
000++++0000++++000000000000000000000000000000000000000000++00000000000+++000000000++000000
000TTTT++++TTTT00000000000000000000000000000000000000000TQTT0000000000TTT00TT0000++++00000
0000000TTTT000000000000000000000++++00000000++++00000000000000000TTTTT0000000000TTTTTT0000
T0000000000000000++00000000TTT00QQTTT0000000TTTT00000000000000TT00000000000000000000000000
0T000000000000000TT0000TTTT0000000000000+++000000000000+++++0T00000000000000000++000000000
00T000000000000T0000Q000000000000000000TTTTT00000000000QTTTQ00000000000000000+0TT000000000
000T000000000000000000000000000000000000000000000000T0000T0000000000000000+00T000000000000
0000T00000000000000000000000000++++++0000000000000T000000T0000000000000000T00T000000000000
0000000000000000000000000000000TTTTTT00000000000T++++++++T0000000000000000T00T00000000H000
AAAAAAAAAAAAAAAAAAAAAAAAAAAAAAAAAAAAAAAAAAAAAAAAAAAAAAAAAAAAAAAAAAAAAAAAAAAAAAAAAAAAAAAAAA
4 47 M
3 68 M
1 72 M
9 12 L
9 17 L
7 32 L
9 35 L
8 59 L
3 1 M
5 18 M
10 43 M
8 65 L
11 68 L
6 80 M
7 76 L
