12 90 5
000000000000000000000000000000000000000000000000000000000000000000000000000000000000000000
000000000000000000000000000000000000000000000000000000000000000000000000000000000000000000
000000000000000000000000000000000000000000000000000000000000000000000000000000000000000000
0000000000000000000000000000000000000000000000000000000000+00000000000000000000000++000000
000000000000000000000000000000000000000000000000000000000TQT000000000000000000000++++00000
000000000000000000000000000000000000000000000000000000000000000000000000000000000TTTT00000
00000000000000000++++00000000000TQQT000000000000000000000000000000000000000000000000000000
00000000000000000TTTT0000T00000000000000000000000000000000+000000000000000000T000000000000
T000000000000000000QQ0000000000000000000000000000000000000T000000000000000000T000000000000
T0000000000TQT000000000000000000000000000000+++0000000000+T+0000000000000T000T000000000000
T0000000000000000T0000000000000+++++00000000+++000000000+TTT+000000000000T000T000000000000
T000000000000000000000000000000TTTTT00000000+++00000000+TTTTT+00000000000T000T000000H00000
AAAAAAAAAAAAAAAAAAAAAAAAAAAAAAAAAAAAAAAAAAAAAAAAAAAAAAAAAAAAAAAAAAAAAAAAAAAAAAAAAAAAAAAAAA
9 3 M
9 6 M
9 12 L
9 18 L
6 12 R