000000000000000000000000000000000000000000000000000000000000000000000000000000000000000000
0000000000000000QQ0000000000000000000+00+0000000000000000000000000000000000000000000000+00
00000000000000000000000000000000000TTQTTQTT000000000++++000000000000000000000000000000+++0
00000000000000++++++00000000000000000000000000000000TTTT00000000000000000000000000000+++++
000000++++0000TTTTTT00000000000000000000000000000000000000000000000000000000000000000TTTTT
000000TTTT000000000000000000000+0000TTTTTT000+00000000000000000000000000000000000000000000
000000000000000000000000000+000T+000000000000T00000000000000++000000000000000000TQQT000000
00000000000000000000000+000T000TT+00000000000T0000000000000TQQT000000T000000T0000000000000
0TTTT000000000000000000T000T000TTT+0000000000T00000000000000000000000T000000T0000000000000
00000000000000000000000T000T000TTTT+000000000T0000000000T000000000000T++++++T00000000H0000
000000000000000000000000000000000000000000000000000000000000000000000000000000000000000000
AAAAAAAAAAAAAAAAAAAAAAAAAAAAAAAAAAAAAAAAAAAAAAAAAAAAAAAAAAAAAAAAAAAAAAAAAAAAAAAAAAAAAAAAAA