12 94 0
0000000000000000000000000000000000000000000000000000000000000000000000000000000000000000000000
0000000000000000000000000000000000000000000000000000000000000000000000000000000000000000000000
0000000000000000000000000000000000000000000000000000000000000000000000000000000000000000000000
0000000000000000QQ00000000000000000+00+00000000000000000000000000000000000000000000000+0000000
0000000000000000000000000000000000TQTTQT0000000++++0000000000000000000000000000000000+++000000
0000000000000++++++0TT0000000000000000000000000TTTT000000000000000000000000000000000+++++00000
000000++++000TTTTTT00000000000000000000000000000000000000000000000000000000000000000TTTTT00000
000000TTTT0000000000000000000+000TTTTTTTT00+00000000000000000000000000000000000000000000000000
00000000000000000000000000+00T+000000000000T00000000000000++000000000000000000TQQT000000000000
00000000000000000000000+00T00TT+00000000000T0000000000000TQQT000000T000000T000000000000000+++0
0TTTT000000000000000000T00T00TTT+0000000000T00000000000000000000000T000000T000000000000000TTT0
00000000000000000000000T00T00TTTT+000000000T0000000000T000000000000T++++++T00000000000H0000000
AAAAAAAAAAAAAAAAAAAAAAAAAAAAAAAAAAAAAAAAAAAAAAAAAAAAAAAAAAAAAAAAAAAAAAAAAAAAAAAAAAAAAAAAAAAAAA