12 110 21
00000000000000000000000000000000000000000000000000000000000000000000000000000000000000000000000000000000000000
00000000000000000000000000000000000000000000000000000000000000000000000000000000000000000000000000000000000000
00000000000000000000000000000000000QQ0000000000000000000000000000000000000000000000000000000000000000000000000
000000000000Q0000000000000000000000000000000000000000Q0000000000000000000000000000000000000000000000000000+000
000000000000000000Q000+++000000000000000+00000+000000000000000000000000000000Q000000000000000000000000000+++00
00000000000+++00000000TTT000000000000000T00+00T0000000000000000000000000++00000000TTT0000000000000000000+++++0
000000+++00TTT000+++00000000000000++++00T00T00T0000000000000000000000000TT000++0000000++0000000000000000TTTTT0
00Q000TTT00000000TTT00000000000000TTTT00000T000000000T00QQ000000000000000000TTTT000000TT++00000000000TT0000000
T0000000000000000000000000000000+000000000000000000000000000000000000Q000000000000000000TT++000000000000000000
T+++0000000000000000000000000+00T000000000000000TTT000000000000000Q00000000000000000000000TT++++00000000000000
TTTT0000000000T00000000000000T00T000000TTT000TTT+++00000++000T0000000000000T0000000000000000TTTT000T0000000000
00000000000000T00000000000T00T00T000000000TTT000+++00000TT000T0000000000000T00000000000000000000TTT0000000H000
AAAAAAAAAAAAAAAAAAAAAAAAAAAAAAAAAAAAAAAAAAAAAAAAAAAAAAAAAAAAAAAAAAAAAAAAAAAAAAAAAAAAAAAAAAAAAAAAAAAAAAAAAAAAAA
2 82 H
8 2 Z
7 23 D
9 36 D
8 50 Z
5 7 D
10 54 Z
9 70 Z
8 30 D
8 83 D
9 88 Z
4 106 Z
10 103 Z
7 90 D
9 18 D
4 25 Z
6 58 D
3 84 Z
5 44 Z
9 101 D
9 72 D