12 90 0
000000000000000000000000000000000000000000000000000000000000000000000000000000000000000000
000000000000000000000000000000000000000000000000000000000000000000000000000000000000000000
0000000000000000QQ0000000000000000000+00+0000000000000000000000000000000000000000000000+00
0000000000000000000000000000000000TTQTTQTT00000000000000000000000000000000000000000000+++0
00000000000000++++++00000000000000000000000000000000++++00000000000000000000000000000+++++
000000++++0000TTTTTT00000000000000000000000000000000TTTT0000000000000000000000000000TTTTTT
000000TTTT0000000000000000000000000TTTTTT000+000000000000000000000000000000000000000000000
0000000000000000000000000000000+000000000000T00000000000000++00000000000000000TQQT00000000
000000000000000000000000000+000T+00000000000T0000000000000TQQT0000000000000000000000000000
0TTTT000000000000000000+000T000TT+0000000000T00000000000000000000000T000000T00000000000000
00000000000000000000000T000T000TTT+000000000T0000000000T000000000000T000000T00000000000000
000000T0000000000000000T000T000TTTT+00000000T0000000000T000000000000T++++++T00000000H00000
AAAAAAAAAAAAAAAAAAAAAAAAAAAAAAAAAAAAAAAAAAAAAAAAAAAAAAAAAAAAAAAAAAAAAAAAAAAAAAAAAAAAAAAAAA