12 130 30
0000000000000000000000000000000000000000000000000000000000000000000000000000000000000000000000000000000000000000000000000000000000
0000000000000000000000000000000000000000000000000000000000000000000000000000000000000000000000000000000000000000000000000000000000
00000000000000QQ0000000000000000000000000000000000000000000000000000000000000000000000Q0000000000000000000000000000000000000000000
00000000000000000000000000000000000Q00Q000000000Q0000000000000000000000++0000000000000000000000000000000+++00000000000000000000000
0000000000000++++00000000000000000000000000000000000000000000000000T00+TT+0000000000+++++00000000Q00+++0TTT00000000000000000000000
000000++++00+TTTT+00000000000000000000000000000++++00000000000000T0000T00T000000000TTTQTTT0000000000TTT000000Q00000000000000000000
000000TTTT00T0000T0000T00000000000TTTTTT0000000TTTT000000000000000000000000000000000000000000000+++0000000000000000000000000000000
0000000000000000000000000000000+000000000000000000000000000++000T0000000000000TQQT00000000000000TTT0000000000+00000000000000000000
00+++00000000000000000000000+00T+00000000000+0000000000000TQQT0000000000000000000000000000000000000000000000+T+000000000000000H000
00TTT00000000000000000000+00T00TT+0000000000T0000000000+000000000000T000000T000000000TTT000000T000000000000+TTT+0000000000000AAAAA
0000000000000000000000+00T00T00TTT+000000000T0000000000T000000000000T000000T000000000TTT000000T00000000000+TTTTT+00000000000TTTTTT
0000000000000000000000T00T00T00TTTT+00000000T0000000000T000000000000T++++++T000000000TTT000000T000000T000+TTTTTTT+000000000TTTTTTT
AAAAAAAAAAAAAAAAAAAAAAAAAAAAAAAAAAAAAAAAAAAAAAAAAAAAAAAAAAAAAAAAAAAAAAAAAAAAAAAAAAAAAAAAAAAAAAAAAAAAAAAAAAAAAAAAAAAAAAAAAAAAAAAAAA
3 8 Y
6 45 E
10 36 U
10 61 E
6 71 U
8 79 U
2 105 Y
9 80 E
3 87 Y
6 111 Y
9 44 Y
8 23 Y
8 75 Y
5 60 Y
1 74 Y
6 126 Y
6 27 E
5 5 E
4 81 E
4 114 E
10 119 E
10 42 E
7 88 E
8 48 U
9 97 U
10 59 U
3 101 U
4 14 U
10 3 U
7 59 U

