12 116 0
00000000000000000000000000000000000000000000000000000000000000000000000000000000000000000000000000000000000000000000
00000000000000000000000000000000000000000000000000000000000000000000000000000000000000000000000000000000000000000000
000000000000000000000000000000Q0000000000000000000000000000000000000000000000000000000000000000000000000000000000000
00000000000000000000000000000000000000000000000000000000000000000000000000000000000000000000000000000000000000000000
00000000000000000000000000000+++0000000000000000000000000000000QTTQ0000000000000000000000000000000000000000000000000
000000000000000000000000000T0TTT00000000000000000000000000000000000000+++++0000000000000000000000000000000000++00000
0000000000000000000000000T0000000Q00Q00000000000000000000000000++++000TTTTT0000000000000000000000000000000+00TT+0000
00000000000000000000TTTT000000000000000000000000000000000++000TTTTTT0000000000000000000000000000000000000+++000T0000
000000000000000000000000000000000000000000000000000++000TTTT000000000000000000000000000000000000000000+00TTT00000000
++++0000000000000T00000000000000000000000000000000TQQT00000000000000000000T00000000000000000000000000TTT0000000H0000
TTTT0000000000T00T00000000000000TT00TT000000000000000000000000000000000T00T0000000T000000000T000000000000000000TTTTT
00000000000000T00T000000000000TT000000TT0000000000000000000000000000000T++T000000000T00000T0000000000000000000000000
WWWWWAAAAAAAAAAAAAAAAAAAAAAAAAAWWWWWWWWAAAAAAAAAAAAAAAAAAAAAAAAAAWWAAAAAAAAAAAAAAAAWAAAAAAAWAAAAAAAAWWWWWWWWWWWWWAAA