12 150 14
000000000000000000000000000000000000000000000000000000000000000000000000000000000000000000000000000000000000000000000000000000000000000000000000000000
000000000000000000000000000000000000000000000000000000000000000000000000000000000000000000000000000000000000000000000000000000000000000000000000000000
000000000000000000000000000000000000000000000000000000000000Q00000000000000000000000000000000000000000000000000000000000000000000000000000000000000000
000000000000000000000000000000000000000000000000000000000000000000000000000000000000000000000000000000000000000000000000000000000000000000000000000000
00000000000000000000000000000000000000000000000000000000000+++0000000000000000000000000000000QTTQ00000000000000000000000000000000000000000000000000000
000000000000000000000000000000000000000000000000000000000T0TTT00000000000000000000000000000000000000+++++0000000000000000000000000000000000++000000000
0000000000000000000000000000000000000000000000000000000000000000000000000000000000000T0000000Q00Q00000000000000000000000000++++000TTTTT00TTTTTTTT00000
00000000000000000000000000000000000000000000000000TTTT000000000000000000000000000000000++000TTTTTT00000000000000000000000000000000000000000+++000T0000
000000000000000000000000000000000000000000000000000000000000000000000000000000000++000TTTT0000000000000000000000000000000000000000000000+00TTT00000000
0000000000000000000000000000000+++0000000000000T00000000000000000000000000000000TQQT00000000000000000000T000000000000000000000000000000TTT000000000H00
0000000000000000000000000000000TTT0000000000T00T00000000000000TT00TT000000000000000000000000000000000T00T0000000000000000000000000000000000000000TTTTT
00000000000000000000000000000000000000000000T00T000000000000TT000000TT0000000000000000000000000000000T++T000000000000000000000000000000000000000000000
AAAAAAAAAAAAAAAAAAAAAAAAAAAAAAAAAWWAAAAAAAAAAAAAAAAAAAAAAAAAAAWWWWWWAAAAAAAAAAAAAAAAAAAAAAAAAAAWWAAAAAAAAWWAAWWAAWWAAAAAAAAAAAAAAAAAAAWWWWWWWWWWWWWAAA
6 11 C
6 44 C
8 28 C
10 66 C
10 69 C
6 87 C
3 3 C
10 73 C
5 100 C
4 83 C
3 41 C
11 24 C
5 56 C
8 31 Z