12 150 28
000000000000000000000000000000000000000000000000000000000000000000000000000000000000000000000000000000000000000000000000000000000000000000000000000000
000000000000000000000000000000000000000000000000000000000000000000000000000000000000000000000000000000000000000000000000000000000000000000000000000000
000000000000000000000000000000000000000000000000000000000000000000000000000000000000000000000000000000000000000000000000000000000000000000000000000000
00000+000000000000000000000000000000000+++000000000000000000000000000000000000000000000000000000000000000000000000000000000000000000000000000000000000
000++T00++00000000000000000000000000000TTT00000000000000000++00000000000000000000000000000000000000000000000000000000000000000000000000000000000000000
000TT000TT0000++000000000000000000000000000000000000000000+TT0Q0000Q000000000000000000000000TTTTT0000000000000000000000000000000000000000000000+++0000
00T0000T00T000TT0000++000000000000000T00000000000000000T00T0000000000000000000000000000++00000000000000000000000000000+T000TTT+0000000000000000TTT0000
0000000000000T00T000TT00000000000+++00000000000000TQT0000000000000000000000000000++000TQQT00000000000000000000000+T000T000Q000Q+00000000000+++00000000
000000000000T000000T00T0000000T00TTQ000000000000000000000000000000000000QTQT0000TQQT000000000000000000000000+T000T000T000T00000Q00000000+00TTT00000000
T00000000000000000T000000TQQ00T0000000000000000T00000000000000000000000000000000000000000000000000000000T000T000T0000000000000000000000TTT000000000000
000000000000000000000000T00000T0000000000000T00T00000000000000TT00TT000000000T00000000000000000000000T00000T000000000000000000000000000000000000000000
00T0T0000000000000000000000000T0000000000000T00T000000000000TT000000TT0000000T00000000000000000000000T0000000000000000000000000000000000000000000H0000
WWWWWWAAAAWWWAAAWWWAAAAWWAAAAAAAAWWAAAAAAAAAAAAAAAAAAAAAAAAAAAWWWWWWAAAAAAAAAAAAAAAAAAAAAAAAWWWWWAAAAAAAAWWAAAWWAAAWWAAAAAAAAAAAAAAAAAWWWWWWWWAAAAAAAA
6 12 K
3 10 K
5 16 K
4 18 K
7 33 R
8 44 R
2 40 R
7 14 I
8 20 I
6 63 I
6 66 I
3 60 R
5 52 R
7 70 K
5 73 K
8 76 K
7 83 R
6 89 R
5 97 R
10 102 I
10 103 I
4 119 R
5 114 R
6 109 R
9 109 I
8 114 I
7 119 I
2 93 H
7 135 K
6 139 K
4 143 K