12 150 7
000000000000000000000000000000000000000000000000000000000000000000000000000000000000000000000000000000000000000000000000000000000000000000000000000000
000000000000000000000000000000000000000000000000000000000000000000000000000000000000000000000000000000000000000000000000000000000000000000000000000000
000000000000000000000000000000000000000000000000000000000000Q00000000000000000000000000000000000000000000000000000000000000000000000000000000000000000
000000000000000000000000000000000000000000000000000000000000000000000000000000000000000000000000000000000000000000000000000000000000000000000000000000
00000+00++0000000000000000000000000000TTT000000000000000000+++0000000000000000000000000000000QTTQ00000000000000000000000000000000000000000000000000000
000++T00TT0000++00000000000000000000000000000000000000000T0TTT00000000000000000000000000000000000000+++++0000000000000000000000000000000000++000000000
000TT00T00T000TT0000++00000000000000T000000000000000000000000000000000000000000000000T0000000Q00Q00000000000000000000000000++++000TTTTT00TTTTTTTT00000
0000000000000T00T000TT0000000000000000000000000000TTTT000000000000000000000000000000000++000TTTTTT00000000000000000000000000000000000000000+++000T0000
0000000000000000000T00T0000000000+++000000000000000000000000000000000000000000000++000TTTT0000000000000000000000000000000000000000000000+00TTT00000000
T000000000000000000000000TQQ0T000TTT00000000000T00000000000000000000000000000000TQQT00000000000000000000T000000000000000000000000000000TTT000000000H00
00T00000000000000000000000000T00000000000000T00T00000000000000TT00TT000000000000000000000000000000000T00T0000000000000000000000000000000000000000TTTTT
0000T000000000000000000000000T00000000000000T00T000000000000TT000000TT0000000000000000000000000000000T++T000000000000000000000000000000000000000000000
WWWWWWAAAAWWWAAAWWWAAAAWWAAAAAAAAWWAAAAAAAAAAAAAAAAAAAAAAAAAAAWWWWWWAAAAAAAAAAAAAAAAAAAAAAAAAAAWWAAAAAAAAWWAAWWAAWWAAAAAAAAAAAAAAAAAAAWWWWWWWWWWWWWAAA
6 12 K
3 10 K
5 16 K
4 18 K
7 33 Y
8 44 Y
2 40 Y