12 34 1
0000000000000000000000000000000000
0000000000000000000000000000000000
0000000000000000000000000000000000
0000000000000000000000000000000000
0000000000000000000000000000000000
0000000000000000000000000000000000
000000TT000000TTTTTT000000TT000000
0000000000TT0000000000TT0000000000
+++0000000000000000000000000000+++
TTTTT000000000000000000000000TTTTT
0000000000000+000000+0000000000000
+++++++++++++T++++++T+++++++++++++
AAAAAAAAAAAAAAAAAAAAAAAAAAAAAAAAAA
2 15 V