12 34 1
0000000000000000000000000000000000
0000000000000000000000000000000000
0000000000000000000000000000000000
0000000000000000000000000000000000
0000000000000000000000000000000000
T00000000000000000000000000000000T
000000TT000000000000000000TT000000
+++000000TT000TTTTTT000TT000000+++
TTTT00000000000000000000000000TTTT
0000000000000000000000000000000000
0000000000000000000000000000000000
+++++T++++++T++++++++T++++++T+++++
AAAAAAAAAAAAAAAAAAAAAAAAAAAAAAAAAA
3 15 V